++++++++++++++++++++++
++    ++++++        ++
+++++     +++++ +++ ++
++ ++ +++ ++    ++  ++
++ ++ ++  ++ +++   +++
++    ++ +++ +++ +++++
++++  ++ ++   ++  ++++
+++  +++    ++   +++++
   ++    ++  +++ +++++
++    ++++++  ++   S++
++++++++++++++++++++++
