 ++++++++++++++++++++++
 + +  ++ ++           +
      +      ++++  ++++
 + +     ++  ++++  ++++
 + + + + ++    +++    +
 +       ++     ++ +  +
 +++++ + +   ++    +  +
 +++++ +++ +  +   ++  +
 +       +  +  S+  +  +
 +++++ +  + + +    +  +
 ++++++++++++++++++++++
